1 13 31
###############################
#p     ** * 3  *   *  * * *   #
# # # #*# # #*#*# # # #*#*#*# #
# x * 2   ***  *      *   * * #
# # # # # #*# # #*#*# # # # #*#
#f   4  b    **f *  *         #
# # # # # # # # # #*# #*# # # #
#*  *    1 *  *      *        #
# # # # #*# # # #*#*# # # # # #
#*    **  *       *           #
# #*# # # # # # #*# # # # # # #
#           *   *  *          #
###############################